NO ./assets/Gem5.xpm
NO ./assets/Gem5.xpm
SO ./assets/Gem6.xpm
WE ./assets/Gem7.xpm

EA ./assets/Gem8.xpm
F 00,153, 255
C 255,255,255

1111111111111111111111111
1000000000000010000000011
100000000000W0000000001
1000000000001000000000011
1111111111111111111111111