NO ./assets/Gem5.xpm
SO ./assets/Gem6.xpm
WE ./assets/Gem7.xpm

EA ./assets/Gem8.xpm


F 0,76,211
C 16,255,255


111111111111111111111111
100000000000000000000001
111000000000100N11111111
111111111000000000000011
100000000000000000000001
11111111111111111111111111
